11111111111
10000000001
10000000001
10000000001
10000000001
10000000001
10000000001
10000000001
10000000001
10000000001
11111111111

11111111111
10001110001
10011111001
10111111101
11111111111
11111111111
11111111111
10111111101
10011111001
10001110001
11111111111